..........................
..........................
..##..##..##..##..##..##..
..##..##..##..##..##..##..
..##..##..##..##..##..##..
%%##..##..##..##..##..##%%
..##..##..##@@##..##..##..
..##..##..##@@##..##..##..
..##..##..##..##..##..##..
..##..##..........##..##..
..##..##..........##..##..
..........##..##..........
..........##..##..........
##..####..........####..##
@@..####..........####..##
..........##..##..........
..........######..........
..##..##..######..##..##..
..##..##~~##..##~~##..##..
..##..##..##..##..##..##..
..##..##%%##..##%%##..##..
..##..##..........##..##..
..##..##..........##..##..
..##..##...####...##..##..
...........#..#...........
...........#..#...........